8 8 8 8 8 8 8 8 8 8 8 8 8 8 8 8 8 8 8 8 8 8 8 8 8 8 8 8 8 8 8 8 8 8 8 8 8 8 8 8 8 8 8 8 8 8 8 8 8 8
8 1 0 0 0 0 0 0 0 0 0 0 0 0 0 0 0 0 0 0 0 0 0 0 0 0 0 0 0 0 0 0 0 0 0 0 0 0 0 0 0 0 0 0 0 0 0 0 0 8
8 0 8 0 2 0 0 0 0 0 0 0 0 0 0 1 0 0 0 0 0 0 0 0 0 0 0 0 0 0 0 0 0 0 0 0 0 0 0 0 0 0 0 0 0 0 0 0 0 8
8 0 0 0 0 0 2 0 0 0 2 0 8 0 0 0 0 0 2 0 0 0 0 0 0 0 0 0 0 0 0 0 0 0 0 0 0 0 0 0 0 0 0 0 0 0 0 0 0 8
8 8 1 0 0 0 0 0 8 0 0 0 1 0 0 0 0 0 0 0 0 0 0 0 0 0 0 0 0 0 0 0 0 0 0 0 0 0 0 0 0 0 0 0 0 0 0 0 0 8
8 8 0 0 8 0 8 0 0 0 2 0 0 0 0 2 0 0 0 0 0 0 0 0 0 0 0 0 0 0 0 0 0 0 0 0 0 0 0 0 0 0 0 0 0 0 0 0 0 8
8 8 8 0 0 0 0 1 0 0 0 0 1 0 0 0 0 0 0 0 0 0 0 0 0 0 3 4 3 4 3 4 3 4 3 4 3 4 3 4 3 4 3 4 3 4 0 0 0 8
8 9 9 9 9 9 9 9 9 9 9 9 9 9 9 9 9 9 9 9 9 9 9 9 0 0 5 6 9 9 9 9 9 9 9 9 9 9 9 9 9 9 9 9 5 6 0 0 0 8
8 9 9 9 9 9 9 9 9 9 9 9 9 9 9 9 9 9 9 9 9 9 9 9 0 0 3 4 9 9 9 9 9 9 9 9 9 9 9 9 9 9 9 9 3 4 0 0 0 8
8 8 8 8 8 8 0 0 0 0 0 0 0 0 0 0 0 0 0 0 0 0 9 9 0 0 5 6 9 9 9 9 9 9 9 9 9 9 9 9 9 9 9 9 5 6 0 0 0 8
8 8 0 8 8 1 0 2 0 1 0 0 2 0 0 0 0 0 0 0 0 0 9 9 0 0 3 4 9 9 9 9 9 9 9 9 9 9 9 9 9 9 9 9 3 4 0 0 0 8
8 0 0 8 8 0 0 0 7 7 7 7 7 7 0 1 0 0 0 0 0 0 9 9 0 0 5 6 9 9 9 9 9 9 9 9 9 9 9 9 9 9 9 9 5 6 0 0 0 8
8 8 8 8 0 0 0 7 7 7 7 7 7 7 7 0 0 0 0 0 0 0 9 9 0 0 3 4 9 9 9 9 9 9 9 9 9 9 9 9 9 9 9 9 3 4 0 0 0 8
8 8 8 8 8 8 7 7 7 7 7 7 7 7 7 7 0 0 0 0 0 0 9 9 0 0 5 6 9 9 9 9 9 9 9 9 9 9 9 9 9 9 9 9 5 6 0 0 0 8
8 8 8 8 0 7 7 7 7 7 7 7 7 7 7 7 7 0 0 0 0 0 9 9 0 0 3 4 3 4 3 4 3 4 9 9 3 4 3 4 3 4 3 4 3 4 0 0 0 8
8 8 8 8 7 7 7 7 7 7 7 7 7 7 7 7 7 7 0 0 0 0 9 9 0 0 5 6 5 6 5 6 5 6 9 9 5 6 5 6 5 6 5 6 5 6 0 0 0 8
8 0 0 7 7 7 7 7 7 7 7 7 7 7 7 7 7 7 7 0 0 0 9 9 1 0 0 0 0 0 0 0 3 4 9 9 3 4 0 0 0 0 0 0 0 0 0 0 0 8
8 0 7 7 7 7 7 7 7 7 7 7 7 7 7 7 7 7 7 7 0 0 9 9 0 0 0 0 2 0 0 0 5 6 9 9 5 6 0 0 0 0 0 0 0 0 0 0 0 8
8 0 7 7 7 7 7 7 7 7 7 7 7 7 7 7 7 7 7 7 0 0 9 9 0 0 0 0 8 0 0 0 3 4 9 9 3 4 0 0 0 0 0 0 0 0 0 0 0 8
8 0 7 7 7 7 7 7 7 7 7 7 7 7 7 7 7 7 7 7 0 0 9 9 0 8 0 0 0 1 0 0 5 6 5 9 5 6 0 0 0 0 0 0 0 0 0 0 0 8
8 0 0 7 7 7 7 7 7 7 1 2 7 7 7 7 7 7 7 0 0 0 9 9 0 0 0 0 1 0 0 0 3 4 9 9 9 4 0 0 0 2 0 0 8 0 0 0 0 8
8 0 0 0 7 7 7 7 7 1 1 2 1 7 7 7 7 7 0 0 0 0 9 9 9 9 9 9 9 9 9 9 9 9 9 9 9 9 9 9 9 0 0 0 0 0 0 0 0 8
8 0 0 0 0 7 7 7 7 0 0 0 0 7 7 7 7 0 0 0 0 0 9 9 9 9 9 9 9 9 9 9 9 9 9 9 9 9 9 9 9 0 0 0 0 0 0 0 0 8
8 0 0 0 0 0 1 0 0 0 9 9 0 0 0 1 0 0 9 9 9 9 9 9 0 0 0 0 0 0 2 0 0 0 0 0 0 0 0 9 9 2 0 0 0 0 0 0 0 8
8 0 0 0 0 0 0 0 0 0 9 9 9 9 9 9 9 9 9 0 0 0 0 0 0 0 0 0 0 0 0 0 0 0 0 0 2 0 0 9 9 0 0 0 0 0 0 8 0 8
8 0 0 8 0 0 0 8 0 2 0 0 0 0 0 0 0 0 0 3 4 3 4 3 4 0 0 0 0 0 0 0 0 0 0 0 0 0 0 9 9 0 0 8 0 0 0 0 0 8
8 0 0 0 0 8 0 0 0 0 0 2 0 0 0 0 0 0 0 5 6 5 6 5 6 0 0 0 0 0 0 0 0 0 0 0 0 0 0 9 9 0 0 0 0 0 0 0 0 8
8 0 0 0 0 0 0 0 0 0 0 0 0 0 0 0 0 0 0 3 4 9 9 3 4 0 0 0 0 0 0 0 0 0 0 0 0 0 0 9 9 0 0 0 0 0 8 0 0 8
8 0 0 0 0 0 0 0 8 0 0 0 0 1 0 0 1 0 0 5 6 9 9 5 6 0 0 0 0 0 0 0 0 0 0 0 0 0 0 9 9 0 0 0 0 0 0 0 0 8
8 0 0 0 0 2 0 0 0 0 0 0 0 0 0 0 0 0 0 3 4 9 9 3 4 3 4 3 4 3 4 0 0 0 0 0 0 3 0 9 9 0 4 0 0 0 0 0 0 8
8 0 0 0 0 0 0 0 0 0 0 0 0 0 0 0 0 0 0 5 6 9 9 5 6 5 6 5 6 5 6 0 0 0 0 0 0 5 6 5 9 5 6 0 0 0 0 0 0 8
8 0 0 0 0 0 0 0 0 0 0 0 0 0 0 0 0 0 0 3 4 9 9 9 9 9 9 9 9 3 4 0 0 0 0 0 0 3 4 9 9 3 4 0 0 0 0 0 0 8
8 0 0 0 0 0 0 0 8 0 0 0 0 2 0 8 0 0 0 5 6 9 9 9 9 9 9 9 9 5 6 0 0 0 0 0 0 5 6 9 9 5 6 0 0 0 0 0 0 8
8 0 0 0 0 0 0 0 0 0 0 0 0 0 0 0 0 0 0 3 4 3 4 3 4 9 9 9 9 3 4 3 4 3 4 3 4 3 4 9 9 3 4 3 4 3 4 0 0 8
8 0 1 0 0 1 0 0 0 0 0 0 0 8 0 2 0 0 0 5 6 5 6 5 6 9 9 9 9 5 6 5 6 5 6 5 6 5 6 9 9 5 6 5 6 5 6 0 0 8
8 0 0 0 0 0 0 0 0 0 0 0 0 0 0 0 0 0 0 0 0 0 0 3 4 9 9 9 9 9 9 9 9 9 9 9 9 9 9 9 9 9 9 9 9 3 4 0 0 8
8 0 0 0 0 0 0 0 0 0 0 0 1 0 0 2 0 0 0 0 0 0 0 5 6 9 9 9 9 9 9 9 9 9 9 9 9 9 9 9 9 9 9 9 9 5 6 0 0 8
8 0 0 0 0 0 1 8 0 0 0 0 0 0 0 0 0 0 0 0 0 0 0 3 4 3 4 3 4 9 9 3 4 3 4 3 4 3 4 9 9 9 9 9 9 3 4 0 0 8
8 0 0 0 0 0 0 0 0 0 0 0 0 0 0 0 0 0 0 0 0 0 0 5 6 5 6 5 6 9 9 5 6 5 6 5 6 5 6 9 9 9 9 9 9 5 6 0 0 8
8 0 0 0 0 0 0 0 0 0 0 0 0 0 0 0 0 0 0 0 0 0 0 0 0 0 0 3 4 9 9 3 4 0 0 0 0 4 4 7 7 7 7 7 7 3 4 0 0 8
8 0 0 0 0 0 0 0 0 1 0 0 0 0 0 0 0 0 0 0 0 0 0 0 0 0 0 5 6 9 9 5 6 0 0 0 0 5 6 7 7 7 7 7 7 5 6 0 0 8
8 0 0 0 1 0 0 0 0 0 0 0 0 2 0 0 0 0 0 0 0 0 0 0 0 0 0 3 4 3 4 3 4 0 0 0 0 3 4 7 7 7 7 7 7 3 4 0 0 8
8 0 0 0 0 0 0 0 0 0 0 0 0 0 0 0 0 0 0 0 0 0 0 0 0 0 0 0 0 0 0 0 0 0 0 0 0 5 6 7 7 7 7 7 7 5 6 0 0 8
8 0 0 0 0 0 0 0 0 0 0 0 0 0 0 0 0 0 0 0 0 0 0 0 0 0 0 0 0 0 0 0 0 0 0 0 0 3 4 7 7 7 7 7 7 3 4 0 0 8
8 0 0 0 0 0 0 0 0 0 0 0 0 0 0 0 0 0 0 0 0 0 0 0 0 0 0 0 0 0 0 0 0 0 0 0 0 5 6 5 6 5 6 5 6 5 6 0 0 8
8 0 0 0 0 0 0 0 0 0 0 0 0 0 0 0 0 0 0 0 0 0 0 0 0 0 0 0 0 0 0 0 0 0 0 0 0 0 0 0 0 0 0 0 0 0 0 0 0 8
8 0 0 0 0 0 0 0 0 0 0 0 0 0 0 0 0 0 0 0 0 0 0 0 0 0 0 0 0 0 0 0 0 0 0 0 0 0 0 0 0 0 0 0 0 0 0 0 0 8
8 0 0 0 0 0 0 0 0 0 0 0 0 0 0 0 0 0 0 0 0 0 0 0 0 0 0 0 0 0 0 0 0 0 0 0 0 0 0 0 0 0 0 0 0 0 0 0 0 8
8 0 0 0 0 0 0 0 0 0 0 0 0 0 0 0 0 0 0 0 0 0 0 0 0 0 0 0 0 0 0 0 0 0 0 0 0 0 0 0 0 0 0 0 0 0 0 0 0 8
8 8 8 8 8 8 8 8 8 8 8 8 8 8 8 8 8 8 8 8 8 8 8 8 8 8 8 8 8 8 8 8 8 8 8 8 8 8 8 8 8 8 8 8 8 8 8 8 8 8